03 08 08 08 08 08 08 08 08 03  
06 00 00 00 00 00 00 00 00 10
06 00 00 00 00 00 00 00 00 10
06 00 00 00 00 00 00 00 00 10
06 00 00 00 00 00 00 00 00 10
06 00 00 00 00 00 00 00 00 10 
06 00 00 00 00 00 00 00 00 10 
03 04 04 04 04 04 04 04 04 03 
